1111111111
1.3......1
1........1
12....1..1
1....21..1
1.11111..1
1..4.....1
1.......21
1........1
1111111111