1111111111
1........1
1........1
1........1
1........1
1........1
1........1
12..3.2421
1........1
1111111111