1111111111
1........1
1........1
1........1
1........1
1........1
1........1
1...322421
1........1
1111111111