1111111111
1........1
1........1
1........1
1........1
1........1
1........1
13.4.22.21
1........1
1111111111