1111111111
1........1
1........1
1........1
1........1
1........1
1........1
12.32..421
1........1
1111111111