1111111111
1........1
1........1
1........1
1........1
1........1
1........1
1234..2.21
1........1
1111111111