1111111111
1........1
1........1
1........1
1........1
1........1
1........1
12.324..21
1........1
1111111111