1111111111
1........1
1........1
1........1
1........1
1........1
1........1
13...2..41
1........1
1111111111