1111111111
1........1
1........1
1........1
1........1
1........1
1........1
1.232.2421
1........1
1111111111