1111111111
1........1
1........1
1........1
1........1
1........1
1........1
123..42.21
1........1
1111111111