1111111111
1........1
1........1
1........1
1........1
1........1
1........1
13.22...41
1........1
1111111111