1111111111
1........1
1........1
1........1
1........1
1........1
1........1
12...32421
1........1
1111111111