1111111111
1........1
1........1
1........1
1........1
1........1
1........1
13..2..4.1
1........1
1111111111