1111111111
1........1
1........1
1........1
1........1
1........1
1........1
123..22241
1........1
1111111111