1111111111
1...22...1
1........1
1...34...1
1........1
1........1
1........1
1........1
1...22...1
1111111111