1111111111
1.......21
1...3....1
1........1
1........1
1....4...1
1......111
12.....121
1........1
1111111111