1111111111
13......41
1........1
1........1
1........1
12......21
1...2....1
1....2...1
12......21
1111111111