1111111111
1........1
13.......1
12.......1
1....2...1
1........1
1........1
1...4...21
1........1
1111111111
0000000000
0000000000