1111111111
12......21
1........1
13.......1
1........1
1........1
14.......1
1........1
12......21
1111111111